*********************************************************
*******                                  ********** *****
******* ******* ******* **************** **********     T
******* ******* ******* ***            * ***        *****
P       ******* ******* **  *********  * *** ****** *****
******* ***          ** *  **********        ****** *****
******* *** ******** **   ************************* *****
******* *** ******** ****************************** *****
***     *** **                         ************ *****
*** ******* ** **** ***** ************************* *****
*** ******* ** **** *****                    ******  ****
*** ********** ************************************  ****
***            ************************************* ****
******** ***************************  ************** ****
******** ********** ****************       ********* ****
********            ****************  **** ********* ****
**************** **                   **** ********* ****
**************** ************************* ********* ****
**************** ************************* **************
**************** *************************          *****
*********************************************************
