*********************************************************
*******                                  ********** *****
******* ******* ******* **************** **********    **
******* ******* ******* ***            * ***        ** **
P       ******* ******* **  *********  * *** ****** ** **
******* ***          ** *  **********        ****** ** **
******* *** ******** **   ************************* ** **
******* *** ******** ********************         * ** **
***     *** **                         ** ******* * ** **
*** ******* ** **** ***** ********* ***** **** ** *    **
*** ******* ** **** *****               *      ** *  ****
*** ********** ************************ ********* *  ****
***                      ***         **           ** ****
***** ** *************** *** *******  ************** ****
***** ** ********** **** *** *******       ********* ****
**    **            **** ***********  ****           ****
** ***** ******* **                   **** ********* ****
** ***** ******* *********** ************* *********    T
**       ******* *********** ************* **************
**************** *********** *************         ******
*********************************************************
